####################
#                  #
#                  #
#                  #
#                  #
#                  #
#      I           #
#                 g#
#    s       D   ###
# U                #
#                  #
#  s               #
#p                 #
##s##########s######
####################
