####################
#                  #
#                  #
#                  #
#                  #
#                  #
#                  #
#                  #
#                 g#
#             d   ##
#          d       #
#       d          #
#    d             #
#p#               w#
####################
