####################
#                  #
#     #      #     #
#    #1#    #1#    #
#    #1#    #1#    #
#    #1#    #1#    #
#     #      #     #
#                  #
#                  #
#p                g#
#######         ####
#              #   #
#        1    #    #
#w                 #
####################
