#########################
#                       #
#                       #
#                       #
#                       #
#                       #
#    #                  #
#    #        R         #
# p11#                 g#
# #####   #   #   #   ###
#                 1     #
#                    U  #
#                       #
#w       111            #
#########################
